###################
#zooooooo#oooooooz#
#o##o###o#o###o##o#
#o@ooooooooooooooo#
#o##o#o#####o#o##o#
#oooo#ooo#ooo#oooo#
####o###o#o###o####
xxx#o#ooooooo#o#xxx
####o#o## ##o#o####
ooooooo# 1 #ooooooo
####o#o#####o#o####
xxx#o#ooooooo#o#xxx
####o#o#####o#o####
#oooooooo#oooooooo#
#o##o###o#o###o##o#
#oo#ooooooooooo#oo#
##o#o#o#####o#o#o##
#oooo#ooo#ooo#oooo#
#o######o#o######o#
#zoooooooooooooooz#
###################
